11
8
4 7 7 7 7 7 7 7 7 7 4 
4 0 0 0 0 0 0 0 0 0 4 
5 0 0 0 0 0 0 0 0 0 5 
5 0 0 0 0 0 0 0 0 0 5 
5 0 0 0 0 0 0 0 0 0 5 
5 0 0 0 0 0 0 0 0 0 5 
5 0 0 0 0 0 0 0 0 0 5 
6 6 6 6 6 6 6 6 6 6 6 